刚才韩雨桐还剩两圈	刚才韩雨桐数还剩两圈
从内到去做超越入弯道的时候	从内到去做超越入弯道的时候
其实还是稍微有一点点勉强的	其是还是杓微有一点点勉强的
令直线入弯道的时候	令直线入弯道提时候
太往外划的话	太亡外遮划的话
那内道身位就让出来了	那哪道身围让出来了
如果是后面追着滑	如靓果师后面追着滑
其他运动员可能会把你那个位置添上	其他运动员可能会把你馁个位置添伤
就说明中国和韩国这两个短道速滑的传统强队	就说明中国和韩国这两个短岛速滑的传统强队
不仅仅是自己争金夺银	不仅仅是自己争进朵银
其实也为这个项目的推广各自做出了自己的贡献	级其实也为个项目的推广各姿凿出资己的贡献
现在的这个规则是如果再发生碰撞的时候	现仔第这个规则是如再发生碰撞的十候
基本上原则还是谁超谁负责	基本商原则还是税超谁负择
短道速滑就体现了体育的另外一个魅力	短憾速滑就体竜现料体育锝另崴一个魅力
在冰刀和鞋之间有一个冰	在冰刀和鞋之间有一个冰
刀托他冰刀也是有弧度和弯度的	刀托他冰刀也是有弧度和弯度的
那么就直接取消这个一千米这个项目的比赛资格	那么就直取梁消著戈一千米这个项目的比赛格
因为直道的时候	阴为直道的时候
前面的人是不能来回横着晃	前面的人是不能来回横着晃
他只能滑他自己那条线路	他知难化拓自己那调仙卢
加拿大选手晋级应该没有什么问题	家拿搭选手晋级应该没有神么问题
一直在前面领滑	一直在前娩领滑
但是经历过这么多年	但是经历过这么多年
将近九年的时间	将近九的时剑
在二零一八年平昌冬奥会团体比赛	灾二零已霸年平昌冬奥会团体比赛
以一个完美的自由滑呈现	以一个万美侠的自由话呈限
证明他又回来了	证冥他又回来了
点冰三周临时改成了连两周	点冰三周吝时改成了连两周
剩下其他的所有动作都按照计划完美的滑出来了	剩暇搜他第所有动都按爪计划湾美得蜉出来了
在比赛当中不紧不慢地把所有的跳跃都完成了	再比赛当中不紧不慢地把所有的挑跃都晚成了
除了在开场的后面点冰三周	除僚在开场地后面点冰三洲
感觉周数不足	感觉周数不足
剩下其他的动作都很稳定的	剩下其他宣的动作都很稳定的
最大区别就是她的滑行速度和深度	最大区别就是她的滑行速度和深度
本赛季他的自由滑曲目选自于获得第七三届奥斯卡最佳影片奖的二零零零年的美国史诗巨作	本腮季他的自友滑曲目选自于获得第七三结奥斯卡最佳影片第二零领零廿得美国史诗巨作
角斗士	角斗士
他的主题是发生在古罗马角斗场上	獭弟主题是发生在古罗马角斗畅上
一段勇气与复仇的故事	一段勇气与复仇的故事
实际上来讲这个动作	实际上来匠这个动作
不是一个特别大的难度动作	不是一隔特别大的难度动作
他的这个质量是让所有的裁判员和运动员都记忆深刻	他的这歌量是让所有的裁判员和运动员都记忆身客
他的意境是在一个夏日的午后	鳎的意境是在一歌夏日的午后
半神半兽的牧神在树荫下小憩	半神半兽的牧神在树荫下小憩
在梦中与爱神相遇的一段奇妙浪漫的梦境	在臣梦中语爱神相遇地一段奇妙浪漫提梦境
我觉得刚才他滑的这套节目可以说是花样滑冰赛场上的印象派作品	我脚得刚才他滑的这套节目可以说是花样滑冰赛尝上的印象派作品
我们看到左上角的角标	我们看到左上角的角标
他的实时技术分只有六三点六四分	他地实时济术分只由六散点六四分
但是他这套节目更像是一个艺术品	惮十他这套节目更像实衣个艺术品
他的每一个伸手投足	他的每义个伸手投足
细节的处理都是那么的这个精巧	细节的处理兜是要的这个精巧
每一个跳跃连接包括步法连接都是那么轻盈	每一个跳跃连接抱括步垡连接都使那么轻盈
他是一定要用心	他事一碇要用心
要用多年的感受一点一点去雕琢的	要用多年地感受一癫一点去雕琢
我们能从他的这个滑行当中能看出来	我们耐从他的著个滑行当中能看出来
他的伸手投足	他的伸手投足
包括四肢的伸展度	包括四肢德伸督
还有旋转姿态的控制	还有旋转姿态第控制
都是非常好	都是飞常好
