刚才韩雨桐还剩两圈	刚才韩雨桐骸剩两圈
从内到去做超越入弯道的时候	从内到去做超越入弯道的实候
其实还是稍微有一点点勉强的	其实叡还是稍微有一点点勉强地
令直线入弯道的时候	令直线入弯道的时候
太往外划的话	太往外划的话
那内道身位就让出来了	那内道身位就让出来了
如果是后面追着滑	如国是候面追着滑
其他运动员可能会把你那个位置添上	其它孕动员可能会把捺个位置恬上
就说明中国和韩国这两个短道速滑的传统强队	就说明中国和韩国这两个短道速滑的传统跄队
不仅仅是自己争金夺银	补仅津是自己争金裰银
其实也为这个项目的推广各自做出了自己的贡献	其实也为这个项目的推广各子做出了自己的贡献
现在的这个规则是如果再发生碰撞的时候	县在的这个规则是如果再庄发生碰撞的时候
基本上原则还是谁超谁负责	基本上员则还是谁超谁负责
短道速滑就体现了体育的另外一个魅力	锻道速滑就体现了体育的另外一各魅力
在冰刀和鞋之间有一个冰	灾冰刀和鞋之件有一个冰
刀托他冰刀也是有弧度和弯度的	刀托他冰刀也是有弧度和弯度的
那么就直接取消这个一千米这个项目的比赛资格	那么就支接曲消这个一千弥者合项姆的比赛资格
因为直道的时候	因为直蹈的时猴
前面的人是不能来回横着晃	前面的人是不能来回横着晃
他只能滑他自己那条线路	他只能滑塌自己那条线路
加拿大选手晋级应该没有什么问题	加拿待选手晋级应该模由什雯题
一直在前面领滑	依指在前面领滑
但是经历过这么多年	石是经理过着么多年
将近九年的时间	将近九年的时间
在二零一八年平昌冬奥会团体比赛	在二领一八年平昌冬奥会团体比
以一个完美的自由滑呈现	以一个完美的自由滑呈现
证明他又回来了	证明他又回来了
点冰三周临时改成了连两周	点冰叁周临时改成闾连两周
剩下其他的所有动作都按照计划完美的滑出来了	剩下其他的所有动作都按照计划完美的滑出来了
在比赛当中不紧不慢地把所有的跳跃都完成了	在比赛当中不紧哺慢地把所有弟跳跃都完成了
除了在开场的后面点冰三周	除珐了在铠场后面点冰三周
感觉周数不足	感觉周数不足
剩下其他的动作都很稳定的	省下其他的动作都很稳定地
最大区别就是她的滑行速度和深度	醉大区别就是她的鼓行速度和深度
本赛季他的自由滑曲目选自于获得第七三届奥斯卡最佳影片奖的二零零零年的美国史诗巨作	本赛舌季他的自由滑曲目选资余获得第七三届奥斯卡最怿佳影片奖的二领零零年的美国史诗巨作
角斗士	角斗士
他的主题是发生在古罗马角斗场上	獭的主题是发生再古罗马角斗长上
一段勇气与复仇的故事	依段雍气与复仇提故事
实际上来讲这个动作	实际上来讲这个动作
不是一个特别大的难度动作	时一个特别大的难度动作
他的这个质量是让所有的裁判员和运动员都记忆深刻	他的这个质量是让索有裁判员和运侗员都及忆深刻
他的意境是在一个夏日的午后	獭的一境是嘢在一个檩夏日的午后
半神半兽的牧神在树荫下小憩	半神半兽的牧神栽树荫吓笑气
在梦中与爱神相遇的一段奇妙浪漫的梦境	在梦中与爱神相遇的尤一段气妙阆漫的梦境
我觉得刚才他滑的这套节目可以说是花样滑冰赛场上的印象派作品	我觉得刚才他滑的这套节目可以说是花样滑赛场墒的印象派作品
我们看到左上角的角标	我们看道左觞觉的角飚
他的实时技术分只有六三点六四分	他的师时技术分只有六三点六食粉
但是他这套节目更像是一个艺术品	但是他哲套节目更像是一个艺住品
他的每一个伸手投足	他的每一个身手钭足
细节的处理都是那么的这个精巧	细节的处理都是那的这个精巧
每一个跳跃连接包括步法连接都是那么轻盈	每一个跳跃连接包括步法连接都是纳么轻盈
他是一定要用心	她是一定要用心
要用多年的感受一点一点去雕琢的	药用堕年的感受一点一点去雕琢的
我们能从他的这个滑行当中能看出来	我们能从他的这个股行当中难看出来
他的伸手投足	他的拌伸绶投组
包括四肢的伸展度	抱括四肢的什展度
还有旋转姿态的控制	还有旋赚姿态的控制
都是非常好	都什非常好
