刚才韩雨桐还剩两圈	刚韩域桐还剩两圈
从内到去做超越入弯道的时候	从内祷去做超越入弯道的时候
其实还是稍微有一点点勉强的	旗实还是稍位有一点点勉强的
令直线入弯道的时候	令直线入弯道的士候
太往外划的话	太往外划的话
那内道身位就让出来了	那内道身位就让出来聊
如果是后面追着滑	如果是后面追着
其他运动员可能会把你那个位置添上	其他运动源可能会把你那个位置填上
就说明中国和韩国这两个短道速滑的传统强队	就搠明中国和撼国这椋个短到速滑的船统强队
不仅仅是自己争金夺银	不仅仅使自己争金哆银
其实也为这个项目的推广各自做出了自己的贡献	其实也位这个项目的推广各自昨出了自己的贡献
现在的这个规则是如果再发生碰撞的时候	现在的这个规则什如果哉阀生彭撞的时候
基本上原则还是谁超谁负责	基苯尚源则还是谁超谁负责
短道速滑就体现了体育的另外一个魅力	短道速滑象就体现了题育的领外个魅力
在冰刀和鞋之间有一个冰	在冰刀货鞋之间有一个炳
刀托他冰刀也是有弧度和弯度的	刀托他冰刀也是有户度和弯度锝
那么就直接取消这个一千米这个项目的比赛资格	那么就直接沉取消这个一千米这个项目的比赛资格
因为直道的时候	引为直到帝时候
前面的人是不能来回横着晃	前面的人时不能来回横晃
他只能滑他自己那条线路	他只能滑他自己那条线路
加拿大选手晋级应该没有什么问题	贾拿大选手晋级应该没有什么问题
一直在前面领滑	一直在前面领滑
但是经历过这么多年	是经历过这么多念
将近九年的时间	将近九年得时间
在二零一八年平昌冬奥会团体比赛	在二洹零一八年平昌冬奥会团体陛赛
以一个完美的自由滑呈现	亦一个完美的自由滑呈现
证明他又回来了	证明他又回来了
点冰三周临时改成了连两周	淀冰三周临时改成了恋周
剩下其他的所有动作都按照计划完美的滑出来了	剩下其他的所有动作都按照计划完美的话出来了
在比赛当中不紧不慢地把所有的跳跃都完成了	在比当中不紧不慢地把所有的跳跃都完成了
除了在开场的后面点冰三周	褚了在开场的厚面点并三周
感觉周数不足	敢觉周述俎
剩下其他的动作都很稳定的	剩下其他的动做都很稳定的
最大区别就是她的滑行速度和深度	最大区别究是她的滑行速度和深度
本赛季他的自由滑曲目选自于获得第七三届奥斯卡最佳影片奖的二零零零年的美国史诗巨作	夯赛季獭自又滑曲目选子于获得第七散届奥斯卡醉佳影翩奖的零零零年的美国史诗巨作
角斗士	爵斗士
他的主题是发生在古罗马角斗场上	他提诸题是发生在古裸马角斗场上
一段勇气与复仇的故事	一段勇气与复仇的事
实际上来讲这个动作	实际上讲这革动作
不是一个特别大的难度动作	不讶是一个特瘪大的难度动作
他的这个质量是让所有的裁判员和运动员都记忆深刻	他的这个质橱量士让所有的裁判员和运动员都记忆深刻
他的意境是在一个夏日的午后	他的意是在以个厦日锝午后
半神半兽的牧神在树荫下小憩	半神搬兽的牧神在树荫下小气
在梦中与爱神相遇的一段奇妙浪漫的梦境	在梦冢余爱神相遇的一段奇妙漫的梦
我觉得刚才他滑的这套节目可以说是花样滑冰赛场上的印象派作品	我觉得刚才馒滑的这套节目课以潭说是花样滑冰赛场上的印象派作品
我们看到左上角的角标	我们看到左上角的角标
他的实时技术分只有六三点六四分	他的实时技术分只有六三点六四癵
但是他这套节目更像是一个艺术品	是它这套节目更像是一个意主骂
他的每一个伸手投足	他的每一个伸手透足
细节的处理都是那么的这个精巧	细节的处理都时那约第这个精巧
每一个跳跃连接包括步法连接都是那么轻盈	每一个跳连接包括步法连接都是那么情盈
他是一定要用心	他是一定要用心
要用多年的感受一点一点去雕琢的	要用朵撵的感受一店一点去雕琢的
我们能从他的这个滑行当中能看出来	我们能从他的这个滑行当中能看出来
他的伸手投足	的伸首投足
包括四肢的伸展度	包括四肢第伸展度
还有旋转姿态的控制	还有眩转咨态的崆制
都是非常好	都是非常好
